word	reading	pos	meaning
一	イチ	num・a-no・a-no・n	one・best・first;foremost・beginning;start
一つ	ひと.つ	num・n	one・for one thing
二	ニ	num	two
二つ	ふた.つ	num	two (things)
三	サン	num・pref	three・tri-
三つ	みっ.つ	num	three (things)
一人	ひと.り	n	one person
二人	ふた.り	n	two people;pair;couple
本人	ホン.ニン	n,a-no	the person themself;the person in question
入る	はい.る	v5r,vi	to enter;to go into
入れる	い.れる	v1,vt	to put in;to let in;to take in;to bring in;to insert・to set (a jewel, etc.);to ink in (e.g. a tattoo)
火	ひ	n,n-suf	fire;flame;blaze
口	くち	n・ctr	mouth・counter for mouthfuls
人口	ジン.コウ	n	population
入口	いり.ぐち	n,a-no	entrance;entry;gate;approach;mouth
回る	まわ.る	v5r,vi	to turn;to revolve
日	ひ	n-adv,n-t・n	day・sun
一日	イチ.ニチ	n	one day
二日	ふつ.か	n	the second day of the month
三日	みっ.か	n	the third day of the month
日本	ニ.ホン・ニッ.ポン	n	Japan
白	しろ	n	white
白い	しろ.い	a-i	white
白人	ハク.ジン	n,a-no	white person;Caucasian
月	つき	n・n-t	moon・month
一月	イチ.ガツ	n-adv	January
一月	ひと.つき	n	one month
目	め	n・suf	eye;eyeball・ordinal number suffix
自ら	みずか.ら	n	oneself
耳	みみ	n	ear
見る	み.る	v1,vt・aux-v,v1	to see;to look;to watch;to view;to observe・to try;to try out;to test
見せる	み.せる	v1,vt	to show;to display
見つかる	み.つかる	v5r,vi	to be found;to be discovered
見える	み.える	v1,vi	to be seen;to be in sight
四	シ	num	four
四	よん	num	four
四つ	よっ.つ	num	four (things)
四日	よっ.か	n	the fourth day of the month
五	ゴ	num	five
五つ	いつ.つ	num	five (things)
五日	いつ.か	n	the fifth day of the month
六	ロク	num	six
六つ	むっ.つ	num	six (things)
六日	むい.か	n	the sixth day of the month
七	シチ	num	seven
七	なな	num	seven
七つ	なな.つ	num	seven (things)
七日	なの.か	n-adv	the seventh day of the month
七月	シチ.ガツ	n-adv	July
八	ハチ	num	eight
八つ	やっ.つ	num	eight (things)
八日	よう.か	n	the eighth day of the month
九	キュウ・*ク	num	nine
九つ	ここの.つ	num	nine (things)
九日	ここの.か	n	the ninth day of the month
丸い	まる.い	a-i	round (spherical)・harmonious;calm
丸で	まる.で	adv・adv	quite;entirely;completely;at all・as if;as though;just like
日の丸	ひ.の.まる	n	the sun represented as a red circle
一丸	イチ.ガン	n	lump;(into) one
力	ちから	n	force;strength;might;vigor;energy
刀	かたな	n	(single-edged) sword;katana
自分	ジ.ブン	pn	myself;yourself;oneself
分かる	わ.かる	v5r,vi	to understand;to comprehend;to grasp;to see;to get;to follow
切る	き.る	v5r,vt・v5r,aux-v	to cut;to cut through;to perform (surgery)・to finish;to complete
一切	イッ.サイ	n,a-no・n-adv	all;everything;the whole;lock, stock, and barrel・absolutely not (with negative);without exception;entirely not
十	ジュウ	num	ten
十分	ジュウ.ブン・*ジュッ.プン・*ジッ.プン	a-na・n,vs・adv	plenty;enough;sufficient;satisfactory;adequate・division into ten・perfectly;thoroughly;fully;in full
十日	とお.か	n	the tenth day of the month
木	き	n	tree;shrub;bush
林	はやし	n,nv	woods;forest;copse;thicket
森	もり	n	forest
森林	シン.リン	n,a-no	forest;woods
米	こめ	n	(husked grains of) rice
日米	ニチ.ベイ	n	Japan-America
来月	ライ.ゲツ	n-adv,n-t	next month
来る	く.る	vk,vi・vk,vi,aux-v・vk,vi	to come (spatially or temporally);to approach;to arrive・to come back;to do ... and come back・to come from;to be caused by;to derive from
上げる	あ.げる	v1,vt・v1,aux-v	to raise;to do up・to do for (the sake of someone else);to complete
上	うえ	n,a-no,n-adv,n-suf・n-suf	above;up;over・suffix indicating higher social standing
下げる	さ.げる	v1,vt	to hang;to suspend;to wear (e.g. decoration)
下さい	くだ.さい	exp	please give me
下	した	n・n,a-no・n	below;down;under;younger (e.g. sibling)・inferiority;one's inferior (i.e. one's junior)・trade-in
下る	くだ.る	v5r,vi	to descend;to go down;to come down
下ろす	お.ろす	v5s,vt	to take down (e.g. flag, ladder);to launch (e.g. boat);to unload;to let (a person) off・to withdraw (cash)・to wear (clothing) for the first time・to fillet (e.g. a fish)
中	なか	n	inside;in
日中	ニッ.チュウ	n-adv,n-t・n	daytime;during the day・Sino-Japanese
仲	なか	n	relation;relationship
休み	やす.み	n,nv	rest;recess;respite
休む	やす.む	v5m,vi	to be absent;to take a day off
体	からだ	n,a-no・n・n,a-no・n	body・torso;trunk・health・corpse;dead body
一体	イッ.タイ	adv・n・n-adv	...in the world (e.g. "what in the world?")・one object;one body;unity・generally;in general
小さい	ちい.さい	a-i	small;little;tiny
小さな	ちい.さな	a-pn	small;little;tiny
少し	すこ.し	adv,n	small quantity;little;few;something
少ない	すく.ない	a-i	few;a little;scarce;insufficient;seldom
大切	タイ.セツ	a-na,n	important;necessary;indispensable
大きい	おお.きい	a-i	big;large;great
大きな	おお.きな	a-pn	big;large;great
大分	ダイ.ブ	adv	considerably;greatly;a lot
大体	ダイ.タイ	n・n-adv,n-t	outline;main point;gist・general;substantially;approximately;about
犬	いぬ	n・n-pref	dog (Canis (lupus) familiaris)・counterfeit;inferior;useless;wasteful
太い	ふと.い	a-i	fat;thick
太る	ふと.る	v5r,vi	to grow fat (stout, plump);to become fat;to gain weight
天下り	あま.くだ.り	n,vs	retiring high-ranking government officials taking a lucrative job in a private or semi-private corporation
川	かわ	n・suf	river;stream・River;the ... river
小川	お.がわ	n	stream;brook;creek
州	シュウ	n,n-suf・suf	state;province;county;oblast;department (of ancient China)・dear
九州	キュウ.シュウ	n	Kyushu (southernmost of the four main islands of Japan)
水	みず	n	water (esp. cool, fresh water, e.g. drinking water)
氷	こおり	n,nv	ice
子	こ	n	child・player who is not a dealer (in cards, mahjong, etc.)・bird egg
字	あざ	n,suf	section of village
大学	ダイ.ガク	n	university;college
入学	ニュウ.ガク	n,vs	entry to school or university;matriculation;enrollment (in university, etc.)
学ぶ	まな.ぶ	v5b	to study (in depth);to learn;to take lessons in
女	おんな	n	female;woman;female sex・female lover;girlfriend;mistress;(someone's) woman
女の子	おんな.の.こ	exp,n	girl;daughter
女子	ジョ.シ	n,a-no	woman;girl
少女	ショウ.ジョ	n・expl	little girl;maiden;young lady・female usually between 7 and 18 years old
安い	やす.い	a-i	cheap;inexpensive
目安	め.やす	n	criterion;standard;yardstick;reference;aim
好き	す.き	a-na,n,nv	liked;well-liked;favorite
大好き	ダイ.す.き	a-na,nv	like very much;loveable
好み	この.み	n,nv	liking;taste;choice
水田	スイ.デン	n	(water-filled) paddy field
男	おとこ	n	man;male・fellow;guy;chap;bloke
男子	ダン.シ	n	youth;young man
お父さん	お.とう.さん	n	father;dad;papa;pa;pop;daddy;dada
交わす	か.わす	v5s,vt・v5s	to exchange (messages, greetings, arguments, etc.)・... with one another;... to each other
学校	ガッ.コウ	n	school
小学校	ショウ.ガッ.コウ	n	primary school;elementary school;grade school
中学校	チュウ.ガッ.コウ	n	junior high school;middle school;lower secondary school
効力	コウ.リョク	n	effect;efficacy;validity;potency
効く	き.く	v5k,vi	to be effective;to show effect
百	ヒャク	num	100;hundred
千	セン	num	thousand;1,000
千切る	ち.ぎ.る	v5r,vt・v5r	to tear to pieces;to tear to shreds;to tear up・to do ... heavily;to do ... heartily;to do ... vigorously
万一	マン.イチ	n・adv	emergency;unlikely event・by some chance;by some possibility
放る	ホウ.る	v5r,vt	to throw;to fling;to hurl;to toss
放す	はな.す	v5s,vt	to release;to let go;to free;to set free;to let loose;to turn loose
言う	い.う	v5u	to say;to utter;to declare
一言	ひと.こと	n,vs	single word;a few words;brief comment
訪ねる	たず.ねる	v1,vt	to visit;to call on;to pay a visit to
訪中	ホウ.チュウ	n,vs	visit to China
防ぐ	ふせ.ぐ	v5g,vt	to defend against;to protect against
円	エン	n	Japanese monetary unit
円い	まる.い	a-i	round (circular)
内	うち	n,a-no・pn,a-no・n・pn,a-no	inside;within・we (referring to one's in-group, e.g. company, etc.);our・imperial palace grounds・I (primarily used by women and children);me
肉	ニク	n	meat;flesh
太り肉	ふと.り.じし	a-no,n	corpulent;fat;chubby
山	やま	n,ctr・n	mountain;hill・crown (of a hat);thread (of a screw);tread (of a tire);protruding part of an object
火山	カ.ザン	n,a-no	volcano
山林	サン.リン	n	mountain forest
氷山	ヒョウ.ザン	n	iceberg
出口	で.ぐち	n	exit;gateway;way out;outlet;leak;vent
出す	だ.す	v5s,vt・v5s	to take out;to get out・to begin ...;to start to ...;to burst into ...
出来る	で.き.る	v1,vi	to be able (in a position) to do;to be up to the task
出る	で.る	v1,vi	to leave;to exit;to go out;to come out;to get out
出かける	で.かける	v1,vi	to go out (e.g. on an excursion or outing);to leave;to depart;to start;to set out
土	つち	n	earth;soil;dirt;clay;mud
古い	ふる.い	a-i	old;aged;ancient;antiquated;antique;timeworn
中古	チュウ.コ	n-t,a-no・n	used;second-hand;old・Middle Ages
早い	はや.い	a-i	early (in the day, etc.);premature・easy;simple;quick
草	くさ	n・exp	grass;weed;herb;thatch・laughter;LOL
王子	オウ.ジ	n	prince
女王	ジョ.オウ	n,a-no	queen
主に	おも.に	adv	mainly;primarily
玉	たま	n・n	ball;sphere;globe;orb・egg
目玉	め.だま	n	eyeball
国	くに	n	country;state
安全	アン.ゼン	n,a-na	safety;security
全て	すべ.て	n,a-no・adv	everything;all;the whole・entirely;completely;wholly;all
お金	お.かね	n	money
安心	アン.シン	a-na,n,vs	relief;peace of mind
中心	チュウ.シン	n,a-no・suf	center;middle;heart;core;focus;pivot;emphasis;balance・-centered;-focused;-oriented
心	こころ	n	mind;heart;spirit
必ず	かなら.ず	adv	always;without exception;necessarily;certainly;without fail;positively;invariably
皿	さら	n・n,ctr・n	plate;dish;platter;disc・serving;helping;course・kanji radical 108 (at the bottom)
血	ち	n	blood;consanguinity
出血	シュッ.ケツ	n,vs	bleeding;hemorrhage
切手	きっ.て	n	stamp (postage);merchandise certificate
手	て	n・n,ctr	hand;arm・move (in go, shogi, etc.)
毛	け	n	hair
干す	ほ.す	v5s,vt	to air;to dry;to desiccate
平日	ヘイ.ジツ	n-adv,n	weekday;ordinary days (i.e. non-holiday)
平ら	たい.ら	a-na,n	flatness;level;smooth;calm;plain;sitting tailor fashion
呼ぶ	よ.ぶ	v5b,vt	to call out (to);to call;to invoke
呼び出す	よ.び.だ.す	v5s,vt	to summon;to call (e.g. phone);to convene;to decoy;to lure
午	うま	n	seventh sign of the Chinese zodiac (The Horse, 11am–1pm, south, May)
許す	ゆる.す	v5s,vt	to permit;to allow;to approve;to consent to
半分	ハン.ブン	n-adv,n	half
大半	タイ.ハン	n,a-no・n-adv	majority;more than half;most (of)・mostly;largely;mainly;predominately;nearly
半ば	なか.ば	n-adv,n,n-suf	middle;half;semi;halfway;partly
牛肉	ギュウ.ニク	n	beef
牛	うし	n	cattle (Bos taurus);cow;bull;ox;calf
村	むら	n	village
付ける	つ.ける	v1,vt	to attach;to join;to add;to append;to affix;to stick;to glue;to fasten;to sew on;to apply (ointment)
日付	ひ.づけ	n,a-no	date;dating
守る	まも.る	v5r,vt	to protect;to guard;to defend
団体	ダン.タイ	n	organization;association
寺	てら	n	temple (Buddhist)
国分寺	コク.ブン.ジ	n	state-supported provincial temple (Nara period)
一時	イチ.ジ	n-t・n-adv,n-t・n-adv,n-t,a-no・n	one o'clock・once;at one time;formerly;before・for a time;for a while;for the time being;for the present;for the moment;temporarily・a time;one time;once
持つ	も.つ	v5t	to hold (in one's hand);to take;to carry
持ち上げる	も.ち.あ.げる	v1,vt	to elevate;to raise;to lift up
特に	トク.に	adv	particularly;especially
特許	トッ.キョ	n,a-no・a-f	patent;special permission;license;concession;franchise;charter・proprietary
詩人	シ.ジン	n	poet
詩	シ	n	poem;verse of poetry
待つ	ま.つ	v5t,vt,vi	to wait
見物	ケン.ブツ	n,vs・n	sightseeing;watching;viewing・sightseer;watcher;spectator
元	もと	n・ctr・n	origin;source・counter for blades of grass, tree trunks, etc., and for falcons (in falconry)・handle (chopsticks, brush, etc.);grip
完全	カン.ゼン	a-na,n,a-no	perfect;complete
完了	カン.リョウ	n,vs,a-no・n	completion;conclusion・perfect (tense, form, aspect)
入院	ニュウ.イン	n,vs	hospitalization
退院	タイ.イン	n,vs	leaving hospital;discharge from hospital
寺院	ジ.イン	n	temple
大学院	ダイ.ガク.イン	n	graduate school
文学	ブン.ガク	n	literature
文字	モ.ジ	n	letter (of alphabet);character
文	ふみ	n	letter;writings
対	ツイ	n・ctr	pair;couple;set・counter for items that come in pairs
右	みぎ	n	right;right hand side
右手	みぎ.て	n・n,a-no	right hand・right-hand side;right-hand direction;(on) the right
若い	わか.い	a-i	young;youthful
若し	も.し	adv	if;in case;supposing
若干	ジャッ.カン	n,a-no・n-adv・a-no,n-adv,n	some;few;a number of;a little (bit)・somewhat;to a certain extent・many;a lot
石	いし	n	stone
岩	いわ	n	rock;boulder
人工	ジン.コウ	n,a-no	artificial;human-made;human work;human skill;artificiality
左	ひだり	n,a-no	left;left hand side
左右	サ.ユウ	n,vs	left and right
又	また	adv,conj,pref	again;and;also;still (doing something)
又は	また.は	conj,exp	or;otherwise
友	とも	n	friend;companion;comrade;pal
友人	ユウ.ジン	n	friend
有る	あ.る	v5r-i,vi	to be;to exist;to live
有効	ユウ.コウ	a-na,n・n	valid;effective・yuko (judo)
お母さん	お.かあ.さん	n	mother;mom;mum;ma
父母	フ.ボ	n	father and mother;parents
毎月	マイ.つき	n-adv,n	every month;each month;monthly
毎日	マイ.ニチ	n-adv,n-t	every day
海	うみ	n	sea;ocean;waters
梅	うめ	n	Japanese apricot (Prunus mume);Japanese plum;ume;Chinese plum
梅干し	うめ.ぼ.し	n,nv	umeboshi;pickled dried ume;pickled dried plum
悔しい	くや.しい	a-i	vexing;annoying;frustrating;regrettable;mortifying
悔い	く.い	n,nv	regret;repentance
元気	ゲン.キ	a-na,n	lively;full of spirit;energetic;vigorous;vital;spirited
天気	テン.キ	n	weather;the elements
気	キ	n	spirit;mind;heart
気分	キ.ブン	n	feeling;mood
気持ち	キ.も.ち	n,nv・adv	feeling;sensation;mood・just a little;somewhat;slightly
気体	キ.タイ	n	gas;vapor
今月	コン.ゲツ	n-adv,n-t	this month
今	いま	n-adv,n	now;the present time;just now;soon;immediately;(one) more
今回	コン.カイ	n-adv,n-t	now;this time;lately
公平	コウ.ヘイ	n,a-na	fairness;impartiality;justice;objectivity
公	おおやけ	a-no,n	official;governmental;formal
夕方	ゆう.がた	n-adv,n-t	evening;dusk
有名	ユウ.メイ	a-na・n	famous・fame
名人	メイ.ジン	n	master;expert
外国人	ガイ.コク.ジン	n	foreigner;foreign citizen;foreign national;alien;non-Japanese
外	そと	n	outside;exterior
外国	ガイ.コク	n,a-no	foreign country
海外	カイ.ガイ	n,a-no	foreign;abroad;overseas
外交	ガイ.コウ	n	diplomacy
多分	タ.ブン	adv・a-na,a-no	perhaps;probably・generous;many;much;great
多い	おお.い	a-i	many;numerous;a lot
多少	タ.ショウ	adv,a-no・n	more or less;somewhat;a little;a few;some・amount;quantity
丁目	チョウ.め	n	district of a town;city block (of irregular size)
打つ	う.つ	v5t,vt	to hit;to strike;to knock;to beat;to punch;to slap;to tap;to bang;to clap;to pound
打つ	ぶ.つ	v5t,vt	to hit (a person);to strike;to beat
町	まち	n	town;block;neighborhood
下町	した.まち	n	low-lying part of a city (usu. containing shops, factories, etc.)
立つ	た.つ	v5t,vi	to stand;to rise;to stand up
位	くらい	adv・n	throne;crown;(nobleman's) seat・grade (of quality, etc.);level;tier;rank
泣く	な.く	v5k	to cry;to weep;to sob;to howl
悔し泣き	くや.し.な.き	n,nv,vs	crying from vexation;tears of regret
音	おと	n,n-suf	sound;noise;report
物音	もの.おと	n	sounds
五十音	ゴ.ジュウ.オン	n	the Japanese syllabary
意見	イ.ケン	n,vs,a-no	opinion;view;comment
行う	おこな.う	v5u,vt	to perform;to do;to conduct oneself;to carry out
行く	い.く・*ゆ.く	v5k-s,vi・v5k-s,aux-v・v5k-s,vi	to go;to move (in a direction or towards a specific location);to be transported (towards);to reach・to continue・to have an orgasm
来年	ライ.ネン	n-adv,n-t	next year
年	とし	n	year
毎年	マイ.とし	n-t	every year;yearly;annually
少年	ショウ.ネン	n	boy;juvenile;young boy;youth;lad
年月	とし.つき	n	months and years
同じ	おな.じ	a-f,n・adv	same;identical;equal;uniform;equivalent;similar;common (origin);changeless;alike・(usu. part of a 'nara' conditional) anyway;anyhow;in either case
同一	ドウ.イツ	a-no,a-na	identical;same;one and the same;equal
同時	ドウ.ジ	n,a-no	simultaneous;concurrent;same time;synchronous;together
同町	ドウ.チョウ	n	the same town;that town
高い	たか.い	a-i	high;tall
高校	コウ.コウ	n	senior high school;high school
円高	エン.だか	n,vs	appreciation of the yen;strong yen
向こう	む.こう	n	opposite side;other side;opposite direction
向かう	む.かう	v5u,vi	to face
方向	ホウ.コウ	n	direction;orientation;bearing;way
何	なに	pn,a-no・n	what・you-know-what;that
何で	なん.で	adv	why?;what for?・how?;by what means?
荷物	に.モツ	n	luggage;baggage;package
荷	に	n	load;baggage;cargo;freight;goods
出荷	シュッ.カ	n,vs	shipping;shipment;forwarding
河川	カ.セン	n	rivers
氷河	ヒョウ.ガ	n	glacier
欠ける	か.ける	v1,vi	to be chipped;to be damaged;to be broken
次	つぎ	n,nv,a-no	next;following;subsequent
姿	すがた	n・n-suf	figure;form;shape・dressed in ...;wearing ...
歌	うた	n	song
歌う	うた.う	v5u,vt,vi・v5u,vt	to sing・to sing (one's praises in a poem, etc.);to compose a poem;to recite a poem
歌手	カ.シュ	n	singer
糸	いと	n,n-suf	thread;yarn;string
毛糸	け.いと	n,a-no	knitting wool;woollen yarn
体系	タイ.ケイ	n	system;organization;architecture
係	かかり	n,nv	charge;duty;person in charge;official;clerk
会う	あ.う	v5u,vi	to meet;to encounter;to see
絵	エ	n,n-suf	picture;drawing;painting;sketch
付き合い	つ.き.あ.い	n,nv	association;socializing;fellowship
竹	たけ	n	bamboo (Bambusoideae family)
答える	こた.える	v1,vi	to answer;to reply
回答	カイ.トウ	n,vs	reply;answer
等	など	prt	et cetera;etc.;and the like;and so forth
高等学校	コウ.トウ.ガッ.コウ	n	senior high school;high school
平等	ビョウ.ドウ	a-na,a-no,n	equality;impartiality;evenness
高等	コウ.トウ	a-na,n,a-no	high class;high grade
谷	たに	n	valley
谷川	たに.がわ	n	mountain stream
内容	ナイ.ヨウ	n	contents;content;substance;matter;detail;import
品物	しな.もの	n	goods;article;thing
容器	ヨウ.キ	n	container;receptacle;vessel
器	うつわ	n	bowl;vessel;container・ability;capacity;caliber
以下	イ.カ	n	not exceeding;and downward;... and below
以内	イ.ナイ	n,n-suf	within;inside of;less than
以上	イ.ジョウ	n-adv,n-t	not less than;... and more;... and upwards
以外	イ.ガイ	n-adv	with the exception of;excepting
以来	イ.ライ	n-adv,n-t	since;henceforth
以て	もっ.て	exp・exp,conj	with;by;by means of・in addition (to being);moreover;as well as;and
似る	に.る	v1,vi	to resemble;to look like;to take after
似合う	に.あ.う	v5u,vi	to suit;to match;to become;to be like
魚	さかな・*うお	n	fish
金魚	キン.ギョ	n	goldfish
角	かど	n	corner (e.g. desk, pavement)
角	つの	n	horn
三角	サン.カク	n	triangle;triangular
見解	ケン.カイ	n	opinion;point of view
解放	カイ.ホウ	n,vs	release;unleashing;liberation;emancipation;setting free
解く	と.く・ほど.く	v5k,vt	to untie;to unfasten;to unwrap;to undo;to unbind;to unpack
了解	リョウ.カイ	n,vs・exp	comprehension;consent;understanding;agreement・OK;roger (on two-way radio)
込む	こ.む	v5m,vi・v5m,aux-v	to be crowded;to be packed・to go into;to put into;to remain (seated);to be plunged into (silence);to do thoroughly
見込み	み.こ.み	n,nv	hope;promise;possibility;chance;probability;likelihood
衣	ころも	n	clothes;garment
長い	なが.い	a-i	long (distance)
校長	コウ.チョウ	n	principal;headmaster
特長	トク.チョウ	n	forte;merit
根	ね	n	root (of a plant)
大根	ダイ.コン	n	daikon (variety of large white Oriental radish)
限る	かぎ.る	v5r,vt・v5r,vi	to restrict;to limit;to confine・to be restricted to;to be limited to;to be confined to
銀行	ギン.コウ	n,a-no	bank
銀	ギン	n,a-no・n・n,a-no・n	silver (Ag)・silver coin;money・silver color;silver color・bank
銀河	ギン.ガ	n	Milky Way
良い	よ.い	a-i	good;excellent;fine;nice;pleasant;agreeable
仲良し	なか.よ.し	n,a-na	intimate friend;close friend;bosom buddy;chum
食べ物	た.べ.もの	n	food
食べる	た.べる	v1,vt	to eat
食品	ショク.ヒン	n	food;food products;foodstuffs
飲み物	の.み.もの	n,nv	drink;beverage
飲む	の.む	v5m,vt	to drink;to gulp;to swallow;to take (medicine)
飲食	イン.ショク	n,vs	food and drink;eating and drinking
図	ズ	n,n-suf	drawing;picture;diagram;figure;illustration;chart;graph
図る	はか.る	v5r,vt	to plan;to attempt;to devise
食料品	ショク.リョウ.ヒン	n	foodstuff;groceries
料金	リョウ.キン	n	fee;charge;fare
食料	ショク.リョウ	n	food
給う	たま.う	v5u,aux-v・v5u,vt,hon	to do・to give
給料	キュウ.リョウ	n	salary;wages;pay
衣料	イ.リョウ	n	clothing
科学	カ.ガク	n	science
科目	カ.モク	n	(school) subject;curriculum;course
内科	ナイ.カ	n,a-no	internal medicine, i.e. treatment by medical procedures rather than surgical procedures
秋	あき	n-t	autumn;fall
秋分	シュウ.ブン	n	autumn equinox
委ねる	ゆだ.ねる	v1,vt	to entrust (a matter) to;to leave to
案内	アン.ナイ	n・vs	information;guidance;leading・to guide;to show (around);to conduct
答案	トウ.アン	n	examination paper;examination script;answer sheet
香り	かお.り	n	aroma;fragrance;scent;smell
香水	コウ.スイ	n	perfume
四季	シ.キ	n	four seasons
移る	うつ.る	v5r,vi	to move (house);to transfer (department)
移す	うつ.す	v5s,vt	to change;to swap;to substitute;to transfer
不安	フ.アン	a-na,n	anxiety;uneasiness;insecurity;suspense
不可	フ.カ	a-no,a-na,n・n	wrong;bad;improper;unjustifiable;inadvisable・failing grade
不良	フ.リョウ	n,a-no,a-na	bad;poor;inferior・delinquent;hoodlum;hooligan
束	たば	n,n-suf,ctr	bundle;bunch;sheaf
高速	コウ.ソク	a-na,a-no,n・n	high-speed;rapid;express・highway;freeway;expressway;motorway
速やか	すみ.やか	a-na	quick;speedy;prompt;rapid;swift
東	ひがし	n	east
練る	ね.る	v5r,vt・v5r,vi	to knead;to thicken into a paste (stirring over a flame)・to walk in procession;to parade;to march
地図	チ.ズ	n	map
土地	ト.チ	n	plot of land;lot;soil
地位	チ.イ	n	(social) position;status
地元	ジ.もと	n・a-no	home area;home town・local
他	ほか	n,a-no・n-adv	other (place, thing, person);the rest・nothing except;nothing but;nothing apart from;nothing aside from;no choice (but to)
他人	タ.ニン	n	another person;other people;others
池	いけ	n	pond
応じる	オウ.じる	v1,vi,vj	to respond;to satisfy;to accept;to comply with;to apply for
一応	イチ.オウ	adv,a-no・adv	more or less;though not quite satisfactorily;after a fashion;pretty much;roughly;so far as it goes・tentatively;for the time being
応対	オウ.タイ	n,vs	dealing with (people, customers, complaints, etc.);receiving (callers, visitors, etc.);attending to;handling;serving
応える	こた.える	v1,vi	to respond;to answer;to meet (e.g. demands, expectations)
府立	フ.リツ	a-no,n	managed by an urban prefecture;prefectural
広い	ひろ.い	a-i	spacious;vast;wide
拡大	カク.ダイ	n,vs	magnification;enlargement;expansion;amplification
自己	ジ.コ	n,a-no	self;oneself
己	おのれ	pn・adv・exp	oneself (itself, etc.)・by oneself (itself, etc.)・interjection expressing anger or chagrin
日記	ニッ.キ	n	diary;journal
記す	しる.す	v5s	to write down;to note;to jot down
紀元	キ.ゲン	n	era
改める	あらた.める	v1,vt	to change;to alter;to revise;to replace
改良	カイ.リョウ	n,vs	improvement;reform
色	いろ	n	color;hue;tint;shade
特色	トク.ショク	n	characteristic;feature;idiosyncrasy;personal color
絶対	ゼッ.タイ	adv・a-no・n	absolutely;unconditionally・absolute;unconditional;unmistakable・absoluteness
絶えず	た.えず	adv	constantly;always;continually;steadily
止まる	と.まる・*とど.まる	v5r,vi	to stop (moving);to come to a stop
中止	チュウ.シ	n,vs	suspension;stoppage;discontinuance;interruption
防止	ボウ.シ	n,vs	prevention;check
企てる	くわだ.てる	v1,vt	to plan;to plot;to propose;to design;to intend;to contemplate
企む	たくら.む	v5m,vt	to scheme;to plan;to play a trick;to invent;to conspire;to frame up
歩く	ある.く	v5k,vi	to walk
干渉	カン.ショウ	n,vs	interference;intervention;meddling
渉外	ショウ.ガイ	n	public relations;client liaison
足	あし	n	foot
不足	フ.ソク	a-na,n,vs	insufficiency;shortage;deficiency;lack;dearth
走る	はし.る	v5r,vi	to run
走行	ソウ.コウ	n,vs	running a wheeled vehicle (e.g. car);running to program, job, etc.;traveling
起きる	お.きる	v1,vi	to get up;to rise・to blaze up (fire)
起こる	お.こる	v5r,vi	to occur;to happen
正しい	ただ.しい	a-i	right;correct
正午	ショウ.ゴ	n-adv,n-t	noon;midday
改正	カイ.セイ	n,vs,a-no	revision;amendment;alteration
安定	アン.テイ	n,vs,a-na,a-no	stability;steadiness;equilibrium
否定	ヒ.テイ	n,vs,a-no・n	denial;negation;repudiation;disavowal・negation (logic)
特定	トク.テイ	a-no・n,vs	specific;particular;designated;special・specifying;designating;identifying;pinpointing
定める	さだ.める	v1,vt	to decide;to determine
政府	セイ.フ	n	government;administration
政	まつりごと	n	rule;government
午後	ゴ.ゴ	n-adv,n-t	afternoon;p.m.
後ろ	うし.ろ	n,a-no	back;behind;rear
後	あと・*のち	n,a-no・n-adv・n,a-no	behind;rear・more (e.g. five more minutes);left・past;previous
後悔	コウ.カイ	n,vs,a-no	regret;repentance;remorse
冬	ふゆ	n-adv,n-t	winter
冬季	トウ.キ	n	(season of) winter
終わり	お.わり	n,nv	the end
終える	お.える	v1,vt,aux-v・v1,vt	to finish・to graduate
終了	シュウ.リョウ	n,vs	end;close;termination
各自	カク.ジ	n,n-adv	each (person);everyone;individual;respective
客	キャク	n	guest;visitor
条件	ジョウ.ケン	n	condition;term;requirement;qualification;prerequisite
用意	ヨウ.イ	n,vs	preparation;arrangements;provision;getting ready;laying out (e.g. a meal)
信用	シン.ヨウ	n,vs・n	confidence;trust;faith;reputation・credit (finance)
用いる	もち.いる	v1,vt	to use;to make use of;to utilize
勇気	ユウ.キ	n	courage;bravery;valor;nerve;boldness
勇ましい	いさ.ましい	a-i	brave;valiant;gallant;courageous
交通	コウ.ツウ	n,vs	traffic;transportation;communication;exchange (of ideas, etc.);intercourse
通る	とお.る	v5r,vi・v5r	to go by;to pass through;to use (a road);to take (a route);to go via・to do ... completely;to do ... thoroughly
通う	かよ.う	v5u,vi	to go to and from (a place);to go back and forth between;to run between (e.g. bus, train, etc.);to ply between
通信	ツウ.シン	n,vs	correspondence;communication;transmission;news;signal;telecommunications
痛い	いた.い	a-i	painful;sore・exceeding
痛む	いた.む	v5m,vi	to hurt;to ache;to feel a pain
踊る	おど.る	v5r,vi	to dance
穴	あな	n,n-suf	hole
空気	クウ.キ	n	air;atmosphere
空	そら	n・n-pref	sky;the air;the heavens・somehow;vaguely
売る	う.る	v5r,vt	to sell
読む	よ.む	v5m,vt	to read
続ける	つづ.ける	v1,vt,aux-v	to continue;to keep up;to keep on
続く	つづ.く	v5k,vi	to continue;to last;to go on・to occur repeatedly・to lead to;to connect to;to adjoin
西	にし	n	west
東西	トウ.ザイ	n,a-no・exp	east and west・Ladies and Gentlemen!;Your attention, please!;roll-up, roll-up
必要	ヒツ.ヨウ	a-na・n	necessary;needed;essential;indispensable・necessity;need;requirement
要る	い.る	v5r,vi	to be needed;to be wanted
主要	シュ.ヨウ	a-na,n	chief;main;principal;major
腰	こし	n	back;lower back;waist;hips;lumbar region
腰痛	ヨウ.ツウ	n,a-no	lower back (or hip) pain;lumbago
酒	さけ	n	alcohol;sake
日本酒	ニ.ホン.シュ	n	sake;Japanese rice wine
心配	シン.パイ	a-na,n,vs・n,vs	worry;concern;anxiety・care;help;aid;assistance
配る	くば.る	v5r,vt	to distribute;to hand out;to deliver;to deal out;to serve out
物価	ブッ.カ	n	prices of commodities;prices (in general);cost-of-living
評価	ヒョウ.カ	n・vs	valuation;estimation;assessment;evaluation;rating・to value;to assess;to rate;to estimate value
示す	しめ.す	v5s,vt	to (take out and) show;to demonstrate;to tell;to exemplify;to make apparent
会社	カイ.シャ	n	company;corporation
社長	シャ.チョウ	n	company president;manager;director
社会	シャ.カイ	n	society;public;community;the world
お礼	お.レイ	n	thanks;gratitude
札	ふだ	n	ticket;token;check;receipt
改札	カイ.サツ	n,vs	examination of tickets
近い	ちか.い	a-i	near;close;short (distance)
祈る	いの.る	v5r,vt	to pray;to wish
祈り	いの.り	n,nv	prayer;supplication
折る	お.る	v5r,vt	to break;to fracture;to break off;to snap off;to pick (e.g. flowers)
折れる	お.れる	v1,vi	to break;to be broken;to snap;to fracture
時折	とき.おり	n-adv,nv	sometimes
断る	ことわ.る	v5r,vt	to refuse;to reject;to dismiss;to turn down;to decline・to inform;to give notice;to tell in advance・to ask leave;to excuse oneself (from)
継続	ケイ.ゾク	n,vs,a-no	continuation
中継	チュウ.ケイ	n,vs,a-no・n,vs	relay;hook-up・relay broadcasting
継ぐ	つ.ぐ	v5g,vt	to succeed (a person, to a position, etc.);to inherit;to take over;to follow
戸	と	n	door (esp. Japanese-style)
近所	キン.ジョ	n,a-no	neighborhood
所	ところ	n	place;spot;scene;site・whereupon;as a result
羊毛	ヨウ.モウ	n,a-no	wool
羊	ひつじ	n	sheep (Ovis aries)
西洋	セイ.ヨウ	n,a-no	the west;Western countries
東洋	トウ.ヨウ	n,a-no	Orient
海洋	カイ.ヨウ	n,a-no	ocean
遅い	おそ.い	a-i	slow;time-consuming;sluggish
遅れる	おく.れる	v1,vi	to be late;to be delayed;to fall behind schedule;to be overdue
美しい	うつく.しい	a-i	beautiful;lovely
美人	ビ.ジン	n	beautiful woman
南	みなみ	n	south
南米	ナン.ベイ	n	South America
両方	リョウ.ホウ	n,a-no	both;both sides;both parties
満足	マン.ゾク	a-na,n,vs・a-na,n	satisfaction;contentment;complacency・sufficient;enough;adequate;proper
不満	フ.マン	a-na,n	dissatisfaction;displeasure;discontent;complaints;unhappiness;disgruntled
満ちる	み.ちる	v1,vi	to be full
正直	ショウ.ジキ	a-na,n・adv	honest;frank;candid;straightforward・honestly;frankly
直ちに	ただ.ちに	adv	at once;immediately;directly;in person;automatically
植える	う.える	v1,vt	to plant;to grow;to raise
植物	ショク.ブツ	n	plant;vegetation
田植え	た.う.え	n	rice planting
置く	お.く	v5k,vt・v5k,aux-v	to put;to place・to do something in advance
位置	イ.チ	n,vs	place;situation;position;location
速い	はや.い	a-i	fast;quick;hasty
究める	きわ.める	v1,vt	to investigate thoroughly;to master
本	ホン	n・ctr	book;volume;script・counter for long cylindrical things;counter for films, TV shows, etc.;counter for goals, home runs, etc.;counter for telephone calls
退く	しりぞ.く・*ど.く	v5k,vi	to step back;to move back;to retreat・to withdraw (from the presence of a superior);to leave;to exit
否	いや	exp	no;nay・well;er;why
直す	なお.す	v5s,vt・v5s,aux-v	to fix;to correct;to repair・to do over again
直る	なお.る	v5r,vi	to get mended;to be repaired;to be fixed